{
  "id": "cafeteria_small",
  "type": "cafeteria",
  "rows": [
    "############",
    "#..........#",
    "#..........#",
    "#..........#",
    "#..........#",
    "#..........#",
    "#####DD#####"
  ],
  "tags": []
}
