{
  "id": "cell_block_medium",
  "type": "cell_block",
  "capacity": 12,
  "rows": [
    "################",
    "#..#..#..#..#..#",
    "#..#..#..#..#..#",
    "#..............#",
    "#..............#",
    "#######DD#######"
  ],
  "tags": ["cells"]
}
