{
  "id": "medical_small",
  "type": "medical",
  "rows": [
    "########",
    "#......#",
    "#......#",
    "#......#",
    "#......#",
    "###D####"
  ],
  "tags": []
}
